10 10
2 2
1 1 2 4 4 5 6 7 8 9
1 1 2 4 4 5 6 7 8 9
2 2 2 3 4 5 6 7 8 9
3 3 3 3 4 5 6 7 8 9
4 4 4 4 4 5 6 7 8 9
5 5 5 5 5 5 6 7 8 9
6 6 6 6 6 6 6 7 8 9
7 7 7 7 7 7 7 7 8 9
8 8 8 8 8 8 8 8 8 9
