40 100
7 15
11111111111111111111111111111111111
10000000000000000000000000000000001
10000000000000000000000000000000001
10001100011000110001100011000110001
10001100011000110001100011000110001
10000000000000000000000000000000001
10000000000000000000000000000000001
10000000000000000000000000000000001
10000000000000000000000000000000001
10001100011000110001100011000110001
10001100011000110001100011000110001
10000000000000000000000000000000001
10000000000000000000000000000000001
10000000000000000000000000000000001
10000000000000000000000000000000001
10001100011000110001100011000110001
10001100011000110001100011000110001
10000000000000000000000000000000001
10000000000000000000000000000000001
10000000000000000000000000000000001
10000000000000000000000000000000001
10001100011000110001100011000110001
10001100011000110001100011000110001
10000000000000000000000000000000001
10000000000000000000000000000000001
10000000000000000000000000000000001
10000000000000000000000000000000001
10001100011000110001100011000110001
10001100011000110001100011000110001
10000000000000000000000000000000001
10000000000000000000000000000000001
10000000000000000000000000000000001
10000000000000000000000000000000001
10001100011000110001100011000110001
10001100011000110001100011000110001
10000000000000000000000000000000001
10000000000000000000000000000000001
10000000000000000000000000000000001
10000000000000000000000000000000001
10001100011000110001100011000110001
10001100011000110001100011000110001
10000000000000000000000000000000001
10000000000000000000000000000000001
10000000000000000000000000000000001
10000000000000000000000000000000001
10001100011000110001100011000110001
10001100011000110001100011000110001
10000000000000000000000000000000001
10000000000000000000000000000000001
10000000000000000000000000000000001
10000000000000000000000000000000001
10001100011000110001100011000110001
10001100011000110001100011000110001
10000000000000000000000000000000001
10000000000000000000000000000000001
10000000000000000000000000000000001
10000000000000000000000000000000001
10001100011000110001100011000110001
10001100011000110001100011000110001
10000000000000000000000000000000001
10000000000000000000000000000000001
10000000000000000000000000000000001
10000000000000000000000000000000001
10001100011000110001100011000110001
10001100011000110001100011000110001
10000000000000000000000000000000001
10000000000000000000000000000000001
10000000000000000000000000000000001
10000000000000000000000000000000001
10001100011000110001100011000110001
10001100011000110001100011000110001
10000000000000000000000000000000001
10000000000000000000000000000000001
10000000000000000000000000000000001
10000000000000000000000000000000001
10001100011000110001100011000110001
10001100011000110001100011000110001
10000000000000000000000000000000001
10000000000000000000000000000000001
10000000000000000000000000000000001
10000000000000000000000000000000001
10001100011000110001100011000110001
10001100011000110001100011000110001
10000000000000000000000000000000001
10000000000000000000000000000000001
10000000000000000000000000000000001
10000000000000000000000000000000001
10001100011000110001100011000110001
10001100011000110001100011000110001
10000000000000000000000000000000001
10000000000000000000000000000000001
10000000000000000000000000000000001
10000000000000000000000000000000001
10001100011000110001100011000110001
10001100011000110001100011000110001
10000000000000000000000000000000001
10000000000000000000000000000000001
11111111111111111111111111111111111

